11111111111111111111
10000000000000000001
100C0000000000000001
10000000P00000000001
10000000001000000111
10000001000000000001
10000001111000C00001
10000001E00000000001
11111111111111111111
