11111111111111111
10000000000000001
100C0000000000001
10000000P00000001
10000000000000001
10000000000000001
100E0000000000001
10000000000000001
11111111111111111
