11111111111111111111
1000P000000000000001
10000000010000011111
10000000011100011001
10000000010000000011
100C0000010000100001
10000000010000000001
100000000100C0010011
111111000100000100C1
100E0000000C00010001
11111111111111111111