11111111111111111111111111111
10100101001000001010010000001
10100100101010100010010000001
1P0000000C00C000000C000000001
1E0000000000000C00000C0000001
1010010100100C001010010000001
10100100101010111010010000001
1C0000000C00100C10000C0000001
11111111111111111111111111111
