111111111111111111111111111111111111111111111111111111111111111111
1E1000000000000C00000C01111000000000000000000000000000000000000001
101001010010000010100000000000010000000000000000000000000000000001
11100100101111100010010100C001010000000000000000000000000000000001
1P0000000C00C0100000000100000101C000000000000000000000000000000001
111111111111111111111111111111111111111111111111111111111111111111